1,1,1,1,1,1,1,1,1,1,1,1,1,1,1,1,1,1,1,1,1,1,1,1,1,1
0,0,0,0,0,0,0,0,0,0,0,0,0,0,0,0,0,0,0,0,0,0,4,0,0,0
0,0,0,0,0,0,0,0,0,0,0,0,0,0,0,0,0,0,0,0,0,0,4,0,0,0
0,0,0,0,0,0,0,0,0,0,0,0,0,0,0,0,0,0,0,0,0,0,4,7,0,0
0,0,1,6,6,1,0,0,0,0,0,0,0,0,0,0,5,5,0,0,0,0,1,1,5,1
0,0,1,1,1,1,4,4,4,1,9,2,1,6,0,0,0,0,0,0,0,0,1,1,5,1
0,0,6,6,6,1,0,0,0,1,1,1,1,0,0,0,0,0,0,0,0,0,1,1,5,1
0,0,0,0,0,0,0,0,0,0,0,0,0,0,0,0,0,0,0,0,5,5,1,1,5,1
0,0,0,0,0,0,4,0,0,0,0,0,0,0,0,0,0,0,9,0,0,0,1,5,5,1
4,4,4,4,4,4,4,0,0,0,0,0,0,0,0,0,0,1,1,0,0,0,1,5,1,1
0,0,0,0,0,0,0,0,0,4,0,0,0,0,0,0,0,1,1,0,0,0,1,5,1,1
0,0,0,0,0,0,0,0,0,4,0,0,0,0,0,0,0,0,0,0,0,0,1,5,1,1
0,0,0,4,4,0,0,0,0,0,0,0,0,0,0,0,0,0,0,0,0,0,5,5,1,1
0,8,0,0,0,0,0,0,2,0,0,0,0,0,0,0,0,2,0,1,5,0,1,1,1,1
0,0,0,0,0,0,0,0,1,4,0,0,0,0,0,0,5,1,0,1,5,0,1,1,1,1
0,0,0,0,0,0,0,0,1,1,0,0,0,0,0,0,5,1,0,0,0,0,1,1,1,1
1,1,9,6,6,5,5,5,5,0,0,0,0,0,0,0,0,0,0,0,0,0,1,1,1,1
1,1,1,1,1,0,0,0,0,0,0,0,0,0,0,0,0,0,0,0,0,0,1,1,1,1
1,1,1,1,1,0,0,0,1,1,1,1,1,1,5,5,5,5,5,5,5,5,1,1,1,1
